000000000000000000000000000000
000000000000011111111111110000
000000000000010100000000010000
011111111000010100001111010000
010000001000000100000001110000
010000111111111111000D01000000
010000100000000100000101110000
010000000001111100000101000000
011110000000010000001111100000
001000000001110000001000100000
001111000000011111111000100000
000010000000000100000000000000
000011111110000101000000000000
000000100010000001000011111100
00000011S010000001000010010100
000000100011111111111110010000
000000000010000000000000010000
000111111111111111111111110000
000000000000000000000000000000
