000000000000000000000000000000
000000000111111111110000000000
000000000100000000011110000000
000000000100000000010010000000
0001111111111S1111111110000000
000000000100000000000000000000
000000000100001111111111111000
000000000111111000000000001000
000000000010001000001111111000
000011111110001000001010001000
000010000000001000001010001000
000011000010001000001010001000
0000011111111110000010D0001000
000000000000000000001000001000
000000000001111111111000001000
000000000001000000000000001000
000000000001111111111111111000
000000000000000000000000000000
000000000000000000000000000000
000000000000000000000000000000
