000000000000000000000000000000
000000000000011111111111110000
000000000000010100000000010000
011111111000010100011111010000
010000001000000100010001111100
010000111111111111010101000100
010000100000000100010101110100
010000000001111100010101000100
011110000000010000011111100100
001000000001110000001000100100
001111000000011111111000100100
000010000000000100000000000100
000011111110000111000000000100
000000101010000001000011111100
00000011S110000001000010010100
000000101011111111111110010000
00000000101010100D010100010000
000111111111111111111111110000
000000000000000000000000000000
