00000000000000000000
01111111111111111110
01111111111111111110
01111111111111D11110
01111111111111111110
01111111111111111110
01111S11111111111110
01111111111111111110
01111111111111111110
00000000000000000000
