00000000
01111D00
01001000
0S111110
01001000
01111100
00000000
