000000000000000000000000000000
011111111111111111111111111110
010101010101010101010101010100
011111111111111111111D11111110
010101010101010101010101010100
011111111111111111111111111110
010101010101010101010101010100
011111111111111111111111111110
010101010101010101010101010100
011111111111111111111111111110
010101010101010101010101010100
011111111111111111111111111110
010101010101010101010101010100
011111111111111111111111111110
010101010101010101010101010100
0111111S1111111111111111111110
010101010101010101010101010100
011111111111111111111111111110
010101010101010101010101010100
000000000000000000000000000000
