000000000000000000000000000000
000000000000000000000000000000
000000000000000000000000000000
000000000000000000000000000000
000000000000000000000000000000
000000000001111111110000000000
000000000001010101010000000000
00000000000111111D110000000000
000000000001010101010000000000
000000000001111111110000000000
000000000001010101010000000000
000000000001111S11110000000000
000000000001010101010000000000
000000000001111111110000000000
000000000000000000000000000000
000000000000000000000000000000
000000000000000000000000000000
000000000000000000000000000000
000000000000000000000000000000
000000000000000000000000000000
