000000000000000000000000000000
000000000000011111111111110000
000000000000010100000000010000
011111111000010100011111010000
010000001000000100010001110000
010000111111111111010101000000
010000100000000100010101110000
010000000001111100010101000000
011110000000010000011111100000
001000000001110000001000100000
001111000000011111111000100000
000010000000000100000000000000
000011111110000111000000000000
000000101010000001000011111100
00000011S110000001000010010100
000000101011111111111110010000
00000000101000000D000000010000
000111111111111111111111110000
000000000000000000000000000000
